abstract=abstracto
assert=afirmar
boolean=booleano
break=inter
byte=byte
case=caso
catch=captura
char=cara
class=clase
const=const
continue=continua
default=predet
do=haz
double=doble
else=entonces
enum=enum
extends=extiende
final=final
finally=finalmente
float=flota
for=para
if=si
goto=ira
implements=implementa
import=importar
instanceof=instantede
int=ent
interface=interfaz
long=largo
native=nativo
new=nuevo
package=paquete
private=privado
protected=protegido
public=publico
return=devolver
short=corto
static=estatico
strictfp=estrictopf
super=super
switch=cambia
synchronized=sincronizado
this=esto
throw=lanzar
throws=lanza
transient=transitorio
try=tratar
void=vacio
volatile=volatil
while=mientras
null=nulo

add=sumar
addAll=sumarTodo
append=adjuntar
arraycopy=matrizcopia
author=autor
checkError=revisaError
clearError=aclararError
clone=clon
close=cerrar
contains=contiene
copyOfRange=copiarDeIntervalo
deprecated=depreciado
equals=igual
exception=excepcion
exit=salir
finalize=finalizar
flush=nivelar
format=formato
get=obten
getClass=obtenClase
hashCode=hashCodigo
indexOf=indiceDe
InputStream=EntradaCorriente
isEmpty=esVacio
length=longitud
link=enlace
next=proximo
notify=notifica
notifyAll=notificaTodos
Object=Objeto
OutputStream=SalidaCorriente
param=param
peek=ojear
pop=tap
print=imprimir
println=imprimirDentro
PrintStream=ImprimeCorriente
push=empujar
remove=retirar
return=devlover
search=buscar
see=ver
serial=serie
set=fijar
setErr=fijarErr
setIn=fijarDentro
setOut=fijarFuera
since=desde
size=tamano
throws=anza
toString=aCuerda
version=version
wait=espera
write=escribir
